Upfingen: (Alternativen: upfing)
Göppingen: (Alternativen: göpping)
Dornstetten: (Alternativen: dornstetten)
Denkendorf: (Alternativen: denkhendorf)
Bietigheim: (Alternativen: bietigheim)
Wolfschlugen: (Alternativen: Wolffschlugen)
Winnenden: (Alternativen: Wennenden)
Weiltingen: (Alternativen: Weiltingen)
Waldenbuch: (Alternativen: Waldenbuch)
Waiblingen: (Alternativen: Waiblingen)
Burg Hohenneuffen: (Alternativen: Vestung hohenneuffen, hohen Neuffen)
Ulm: (Alternativen: Ulm)
Tuttlingen: (Alternativen: Tuttlingen)
Tischardt: (Alternativen: Tischandt, Tischard, Tischardt, Tischardt , Tischerdt, Tißhardt)
Templin: (Alternativen: Templing)
Stuttgart: (Alternativen: Stutt gardt, Stuttg, Stuttgard, Stuttgardt, Stuttgardt , Stuttgart)
Sindelfingen: (Alternativen: Sindel fingen)
Seeburg: (Alternativen: Seeburg)
Schwäbisch Gmünd: (Alternativen: Schwäbl. Gmünd)
Schwarzwald: (Alternativen: Schwartzwald)
Schorndorf: (Alternativen: Schorndorf, Schorndorff)
Schlotheim: (Alternativen: Schlot heim, Schlotheim)
Schlierbach: (Alternativen: Schlierbach)
Salzburg: (Alternativen: Saltzburg)
Philippsburg: (Alternativen: Philippsburg)
Pfullingen: (Alternativen: Pfulling, Pfullingen, Pfüllingen, pfulling)
Nürtingen: (Alternativen: Nirttingen, Nurttingen, Nüerntingen, Nürt tingen, Nürtting, Nürttinge, Nürttingen, Nürttingen , Nürttinger, nürttinger)
Neuler: (Alternativen: Neufer, Neuler)
Neuenbürg: (Alternativen: Neuenburg, Neuenbürg)
Neidling: (Alternativen: Neidling, Neidlingen)
Nagold: (Alternativen: Nagold)
Münsingen: (Alternativen: Münsing, Münsingen, Münstingen, Münßingen)
Metzingen: (Alternativen: Metzing, Metzingen, Mezingen)
Maulbronn: (Alternativen: Maulbronn)
Ludwigsburg: (Alternativen: Ludwigsburg)
Köngen: (Alternativen: Köngen, Köngen )
Kornwestheim: (Alternativen: Kornwesten)
Kappishäusern: (Alternativen: Kabishausern, Kabishäuser, Kabishäuseren, Kabishäusern, Kabishäußern, Kabisthäu sern, Kabisthäusern, Kabisthäusern., Kabißhäusern, kabishausern)
Herrenberg: (Alternativen: Herrenberg, Herrenberg )
Grafenberg: (Alternativen: Grafen berg, Grafen-Berg, Grafenbarg, Grafenberg, Grafenberg , Graferberg, grafen berg, grafenBerg, grafenberg)
Großbettlingen: (Alternativen: Gr. Bettlingen, Gr: Bettlingen, Grbettling, Grosen Bettlingen, Groß Bettlingen, Großbettlingen, Großen Bettlingen, GroßenBettlingen, Großenbetllingen, Großenbettling, Großenbettlinge, Großenbettlingen, Großenbettlingen., großen bettlingen, großenbettlingen)
Gomadingen: (Alternativen: Gomadingen)
Frickenhausen: (Alternativen: Fricken Hausen, Fricken hausen, FrickenHausen, Frickenhaus, Frickenhausen, Frickenhausen , Frickenhausen., Frickenhauser, Frickenhaußen, Frickenhaußer, Frickhaus, FrickhenHausen, Frickhenhausen, Frickhenhauser, Frickhenhaußen, Friken hausen, Frikenhaußen, Frikhen Hausen, Frikhenhausen, Frikhenhausen , Frikhenhaußen, fricken Hausen, fricken, haußen, frickhenhausen, frikenhausen, frikhenHausen)
Freiburg: (Alternativen: Freyburg )
Freudenstadt: (Alternativen: Freudenstatt, Freudenstatt )
Eglingen: (Alternativen: Eglingen, Eglinger, Eßlingen)
Ebersbach: (Alternativen: Eberspach)
Donauwörth: (Alternativen: Donauwerth)
Ettlingen: (Alternativen: Dettingen, Ettling, Gbettlingen)
Böblingen: (Alternativen: Böbling , Böblingen, Böblinger, böblingn)
Blaubeuren: (Alternativen: Blaubeur, Blaubeuren)
Asperg: (Alternativen: Asperg, asperg)
Adelberg: (Alternativen: Adelberg)
Kleinbettlingen: (Alternativen:  kleinen bettlingen, Kl. Bettlingen, Kleienbettlingen, Kleinbettl, Kleinbettlingen, Kleinen bettlinge, Kleinenbethling, Kleinenbettling, Kleinenbettlingen, Kleinenbettlingen , Kleinenbettlingen., Kleinerbettlingen, kleinen Bettling, kleinen Bettlingen, kleinen bettlingen, kleinenbelingen, kleinenbettlin, kleinenbettlingen)
Grabenstetten: (Alternativen:  grabenstetten, Graben stett, Graben stetten, Graben stetter, Grabenstet, Grabenstett, Grabenstetten, Grabenstetten , Grabenstetter, Grabenstätten, graben stetten, grabenstett, grabenstetten, grabenstätten)
Neuffen: (Alternativen:  Nauffen,  Neufen,  Neuffen, H. Neuffen, Neufen, Neufen , Neuffen, Neuffer, Neuffn, Neüffen, neufen, neuffen)
Linsenhofen: (Alternativen:  Linsenhofen, Lensen
 Hofen, Lensenhof, Lensenhofen, Lensenhoffen, Linsen Hofen, Linsenhofen, Linsenhofen , linsenhofen, linsenhofen , linßenhofen, linßerhofen, senhofen)
Beuren: (Alternativen:  Beuren , Beuern, Beuren, Beurer, Beurnen, Beüren, beuern, beuren, beuren , beüren)
Balzholz: (Alternativen:  Balzholz, Baltholz, BaltzHolzen, Baltzholt, Baltzholtzen, Baltzholz, Baltzholzen, BalzHolz, Balzholtzen, Balzholtz , Balzholz, Balzholzen, Balzholzer, baltzholtz, baltzholtzen, baltzholz, baltzholzen, balzholtzen, balzholzen)
